********************
*  R *     *     R *
*    *     *    ****
*          *  R    *
*****   ****      O*
*                  *
*     ***     +    *
*    H  *  R *++*  *
*       *          *
********************